60
30
111111111111111111111111111111111111111111111111111111111111
1      1                                           1       1
1             11111111111111111                    1       1
1      1      1               1                    1       1
1      1      1  11111        1                    1       1
1      1      1  1 2    1     1                    1       1
1      1      1  1      1     1                    1       1
1      1                1  1111                    1       1
1      1        111111111  1                               1
1      1                                           1       1
1      11111111111111111111111111111               1       1
1                                  1       111111111       1
1                                  1       1               1
1           1      1     1   1     1       1               1
1           1      1     1   1     1       1               1
1       1111111111111111111111     1       111111111111  111
1                                          1               1
1                                          1 1             1
1      1111111111111111 11111111111111111111  1            1
1      1                                                   1
1      1           1                                       1
1      1           1   111111111111   11                   1
1      1           1   1               1     111111111  1111
1      1           1   1               1     1             1
1      1           1   11111111111111111     1   111 1111  1
1      1           1                         1   1      1  1
1      1           1111111111111111 1111111111   1   3  1  1
1                  1                             1         1
1      1           1                         1   1         1
111111111111111111111111111111111111111111111111111111111111
