60
30
111111111111111111111111111111111111111111111111111111111111
1                                                          1
1                                                          1
1                                  2       2               1
1     2                            2       2               1
1     2                            2       2               1
1     2                    222222222       222222222       1
1222222                                                    1
1                                                          1
1                                      3                   1
1                          			                       1
1                          222222222       222222222       1
1                                  2       2               1
1                                  2       2               1
1                                  2       2               1
1                                                          1
1                                                          1
1                               2            2             1
1                              2              2            1
1          2     2            2                            1
1    2    2       2    2                                   1
1   2    2         2    2                                  1
1       2           2                           222222222221
1             4                                            1
1                                                          1
1       2           2                                      1
1   2    2         2    2                    2             1
1    2    2       2    2                     2             1
1                                            2             1
111111111111111111111111111111111111111111111111111111111111
