60
30
111111111111111111111111111111111111111111111111111111111111
1                                                          1
1                          2                               1
1                                  1       1               1
1     1                            1       1               1
1     1                            1       1               1
1     1                    111111111       111111111       1
1111111                                                    1
1                                                          1
1                                                          1
1                                                          1
1                          111111111       111111111       1
1                                  1       1               1
1                                  1       1               1
1                                  1       1               1
1                                                          1
1                                                          1
1                               1            1             1
1                              1              1            1
1          1     1            1                            1
1    1    1       1    1                                   1
1   1    1         1    1                                  1
1       1           1                           111111111111
1                                                          1
1                                                          1
1       1           1                                      1
1   1    1         1    1       3            1             1
1    1    1       1    1                     1             1
1                                            1             1
111111111111111111111111111111111111111111111111111111111111
